111111111111111111111111111111111111111
100000000000000000000000000000000000001
1000000000000000000E0000000000000000001
100001000000000000111000000000000000001
1000110000000000000C0000000000000000001
100111000000C000000C0000000000000000001
1000000000000C0000000000000000000000001
10000000000000C000000000000000000000001
100000000000000C00000000000000CC0001001
1000E0C0C0CCCCCCC00P0000000000CC0001E01
100000000000000C00000000000000CC0001001
10000000000000C00000000000000C00C000001
1000000000000C00000000000000C0CC0C00001
100000000000C0000000000000000CCCC000001
100000000000000000000000000000000000001
1001110000000000000E0000000000000000001
100011000000000000010000000000000000001
1000010000000000000C0000000000000000001
100000000000000000000000000000000000001
111111111111111111111111111111111111111