11111111111111111111111111
1P000000000000000000000001
10010000000000000000000001
10001001000000000000000001
1000C100100100000000000001
100C0010010010010000000001
10C0CCCCCC0000000C0C00CE01
100C0010010010010000000001
1E00C100100100000000000001
10001001000000000000000001
10010000000000000000000001
10000000000000000000000001
11111111111111111111111111