1111111111
10E0000001
1000001C01
10C0000001
1000110C01
10C0000001
1000000C01
10C0000001
1000110C01
10C0000001
1000001CP1
1111111111